autograph - Автограф
automatic - автоматический
automatically - автоматически
automobile - автомобиль
autumn - осень
auxiliary - вспомогательный
available - доступный
avalanche - снежный обвал
ave - прощание
avenge - мстить
avenue - проспект
average - средний
aversion - отвращение
avoid - избегать
await - ждать
awake - бодрствующий
awakened - Пробужденный
aware - сознающий
away - прочь
awe -  страх
awestruck - пораженный
awful - ужасный
awfully - ужасно
awhile - некоторое время
awkward - неуклюжий
awoke - будил
axis - ось
ay - Да
aye - Утвердительный ответ
bab - Бэб
babble - бормотание
baby - ребенок
back - спина
backed - Поддержанный
background - фон
backs - Задние части
backup - Резервный
backward - назад
backwards - Назад
bacon - бекон
bad - плохой
bade - Предлагал
badge - знак
badger - барсук
badly - сильно
baffle - озадачивать
bag - сумка
bagful - мешок
baggage - багаж
bags - сумки
bail - поручительство
bait - приманка
baker - пекарь
bakery - пекарня
balance - равновесие
balanced - уравновешенный
balcony - балкон
bald - лысый
ball - мяч
ballast - балласт
ballet - балет
balloon - воздушный шар
balloons - Воздушные шары
balmy - душистый
bamboo - бамбук
ban - запрещать
banana - банан
bananas - бананы
band - лента
bandage - бинт
bands - ансамбли
bandy - перебрасываться
bang - ударять
banged - ударенный
banisters - перила
bank - банк
banner - знамя
banquet - банкет
bar - бар
barbara - Барбара
barbed - колючий
bare - голый
barefooted - босой
barely - только
bargain - сделка
barge - баржа
bark - кора дерева
barley - ячмень
barn - амбар
barnabas - Барнабас
barnacle - Моллюск
baron - Барон
barrel - баррель
barren - бесплодный
barrier - барьер
barrow - носилки
bars - Бруски
barton - имение
base - основа
baseball - бейсбол
based - Основанный
basement - основание
basic - основной
basically - в основном
basin - бассейн
basis - основа
basket - корзина
bass - бас
bat - бить
batch - выпечка
bates - Убавляет
bath - ванна
bathe - купаться
bathing - купание
bathroom - ванная комната
battery - аккумулятор
battle - бой
bay - бухта
beach - пляж
beacon - сигнальный огонь
beagle - Гончая
beak - клюв
beaker - кубок
beam - сиять
beamed - Сиял
beaming - Сияющий
beams - Лучи
bean - боб
beans - фасоль
bear - медведь
bearable - терпимый
beard - борода
bearer - носитель
bearing - Отношение
bears - Медведи
beast - зверь
beastly - противный
beasts - звери
beat - ударить
beaten - битый
beating - поражение
beau - кавалер
beautiful - красивый
beautifully - красиво
beauty - красота
became - становился
because - потому что
beck - кивок
become - становиться
becomes - становится
becoming - подобающий
bed - постель
bedding - спальные принадлежности
bedroom - спальня
beds - Кровати
bedside - постель
bee - пчела
beech - бук
beef - говядина
beehive - улей
beer - пиво
bees - Пчелы
beetle - трамбовать
beetroot - красная свекла
before - перед
beforehand - заранее
beg - просить
began - начинал
beggar - нищий
begin - начинать
beginner - новичок
beginning - начало
begins - начинается
begun - Начатый
behalf - Защита
behave - вести себя
behaved - Вел себя
behaviour - поведение
beheld - Созерцал
behind - позади
behold - Созерцать
being - будучи
beings - Существа
belfry - колокольня
belief - вера
believe - верить
believed - верил
believes - Верит
believing - Вера
bell - звонок
bella - Белла
bellamy - Беллами
bellow - мычание
belly - живот
belong - принадлежать
belonged - принадлежащий
belongings - вещи